Index,Region,Subregion,Stage,Confirmed,Deaths,Recovered,Stage_Confirmed,Stage_Deaths,Stage_Recovered,Stage_Treated%,Stage_Deaths%,Stage_Recovered%,Stage_Treated,Recovered_Change
60,Mexico,Unknown,2020-11-16,0,0,754200,0,0,754200,,0.0,1.0,754200,
61,Mexico,Unknown,2020-11-21,0,0,770728,-754200,0,16528,-0.021914611508883585,0.0,1.0,16528,0.0
62,Mexico,Unknown,2020-11-26,0,0,803581,-770728,0,32853,-0.04262593288423413,0.0,1.0,32853,0.0
63,Mexico,Unknown,2020-12-01,0,0,829817,-803581,0,26236,-0.032648855560298215,0.0,1.0,26236,0.0
64,Mexico,Unknown,2020-12-06,0,0,866186,-829817,0,36369,-0.04382773551276968,0.0,1.0,36369,0.0
65,Mexico,Unknown,2020-12-11,0,0,904042,-866186,0,37856,-0.043704239043346346,0.0,1.0,37856,0.0
66,Mexico,Unknown,2020-12-16,0,0,945673,-904042,0,41631,-0.04604985166618365,0.0,1.0,41631,0.0
67,Mexico,Unknown,2020-12-21,0,0,987328,-945673,0,41655,-0.04404799544874391,0.0,1.0,41655,0.0
68,Mexico,Unknown,2020-12-26,0,0,1031864,-987328,0,44536,-0.04510760355221365,0.0,1.0,44536,0.0
69,Mexico,Unknown,2020-12-31,0,0,1074795,-1031864,0,42931,-0.04160528906910213,0.0,1.0,42931,0.0
70,Mexico,Unknown,2021-01-05,0,0,1113137,-1074795,0,38342,-0.03567377965100321,0.0,1.0,38342,0.0
71,Mexico,Unknown,2021-01-10,0,0,1150422,-1113137,0,37285,-0.033495427786516846,0.0,1.0,37285,0.0
72,Mexico,Unknown,2021-01-15,0,0,1199810,-1150422,0,49388,-0.04293033339070359,0.0,1.0,49388,0.0
73,Mexico,Unknown,2021-01-19,0,0,1251782,-1199810,0,51972,-0.04331685850259624,0.0,1.0,51972,0.0
