Index,Region,Subregion,Stage,Confirmed,Deaths,Recovered,Stage_Confirmed,Stage_Deaths,Stage_Recovered,Stage_Treated%,Stage_Deaths%,Stage_Recovered%,Stage_Treated,Recovered_Change
79,China,Unknown,2021-02-19,0,0,1,0,0,1,,0.0,1.0,1,
80,China,Unknown,2021-02-24,0,0,6,-1,0,5,-5.0,0.0,1.0,5,0.0
81,China,Unknown,2021-03-01,0,0,4,-6,0,-2,0.3333333333333333,-0.0,1.0,-2,0.0
82,China,Unknown,2021-03-06,0,0,5,-4,0,1,-0.25,0.0,1.0,1,0.0
83,China,Unknown,2021-03-11,0,0,6,-5,0,1,-0.2,0.0,1.0,1,0.0
84,China,Unknown,2021-03-16,0,0,1,-6,0,-5,0.8333333333333334,-0.0,1.0,-5,0.0
85,China,Unknown,2021-03-21,0,0,3,-1,0,2,-2.0,0.0,1.0,2,0.0
86,China,Unknown,2021-03-26,0,0,3,-3,0,0,-0.0,,,0,
87,China,Unknown,2021-03-31,0,0,1,-3,0,-2,0.6666666666666666,-0.0,1.0,-2,
88,China,Unknown,2021-04-05,0,0,2,-1,0,1,-1.0,0.0,1.0,1,0.0
89,China,Unknown,2021-04-10,0,0,2,-2,0,0,-0.0,,,0,
90,China,Unknown,2021-04-14,0,0,3,-2,0,1,-0.5,0.0,1.0,1,
