Index,Region,Subregion,Stage,Confirmed,Deaths,Recovered,Stage_Confirmed,Stage_Deaths,Stage_Recovered,Stage_Treated%,Stage_Deaths%,Stage_Recovered%,Stage_Treated,Recovered_Change
30,Mexico,Unknown,2020-11-16,0,0,754200,0,0,754200,,0.0,1.0,754200,
31,Mexico,Unknown,2020-11-26,0,0,803581,-754200,0,49381,-0.06547467515247944,0.0,1.0,49381,0.0
32,Mexico,Unknown,2020-12-06,0,0,866186,-803581,0,62605,-0.07790751647935927,0.0,1.0,62605,0.0
33,Mexico,Unknown,2020-12-16,0,0,945673,-866186,0,79487,-0.09176666443465953,0.0,1.0,79487,0.0
34,Mexico,Unknown,2020-12-26,0,0,1031864,-945673,0,86191,-0.09114249851692921,0.0,1.0,86191,0.0
35,Mexico,Unknown,2021-01-05,0,0,1113137,-1031864,0,81273,-0.07876328663467279,0.0,1.0,81273,0.0
36,Mexico,Unknown,2021-01-15,0,0,1199810,-1113137,0,86673,-0.07786373105915984,0.0,1.0,86673,0.0
37,Mexico,Unknown,2021-01-25,0,0,1335876,-1199810,0,136066,-0.11340628932914378,0.0,1.0,136066,0.0
38,Mexico,Unknown,2021-02-04,0,0,1450237,-1335876,0,114361,-0.08560749650416656,0.0,1.0,114361,0.0
39,Mexico,Unknown,2021-02-14,0,0,1548174,-1450237,0,97937,-0.06753172067737893,0.0,1.0,97937,0.0
40,Mexico,Unknown,2021-02-24,0,0,1614614,-1548174,0,66440,-0.04291507285356814,0.0,1.0,66440,0.0
41,Mexico,Unknown,2021-03-06,0,0,1666658,-1614614,0,52044,-0.032233091005032785,0.0,1.0,52044,0.0
42,Mexico,Unknown,2021-03-16,0,0,1716135,-1666658,0,49477,-0.029686354369042718,0.0,1.0,49477,0.0
43,Mexico,Unknown,2021-03-26,0,0,1755798,-1716135,0,39663,-0.023111818126196365,0.0,1.0,39663,0.0
44,Mexico,Unknown,2021-04-05,0,0,1791894,-1755798,0,36096,-0.020558173548437805,0.0,1.0,36096,0.0
45,Mexico,Unknown,2021-04-15,0,0,1820959,-1791894,0,29065,-0.01622026749350129,0.0,1.0,29065,0.0
46,Mexico,Unknown,2021-04-25,0,0,1850680,-1820959,0,29721,-0.01632161954223022,0.0,1.0,29721,0.0
47,Mexico,Unknown,2021-05-05,0,0,1877347,-1850680,0,26667,-0.01440929820390343,0.0,1.0,26667,0.0
48,Mexico,Unknown,2021-05-15,0,0,1899742,-1877347,0,22395,-0.011929067987963867,0.0,1.0,22395,0.0
49,Mexico,Unknown,2021-05-25,0,0,1917958,-1899742,0,18216,-0.009588670461567939,0.0,1.0,18216,0.0
50,Mexico,Unknown,2021-05-29,0,0,1924865,-1917958,0,6907,-0.003601225887115359,0.0,1.0,6907,0.0
