Index,Region,Subregion,Stage,Confirmed,Deaths,Recovered,Stage_Confirmed,Stage_Deaths,Stage_Recovered,Stage_Treated%,Stage_Deaths%,Stage_Recovered%,Stage_Treated,Recovered_Change
296,Mexico,Unknown,2020-11-12,0,0,736197,0,0,736197,,0.0,1.0,736197,
297,Mexico,Unknown,2020-11-13,0,0,741340,-736197,0,5143,-0.006985901871374102,0.0,1.0,5143,0.0
298,Mexico,Unknown,2020-11-14,0,0,745361,-741340,0,4021,-0.0054239620147300835,0.0,1.0,4021,0.0
299,Mexico,Unknown,2020-11-15,0,0,750190,-745361,0,4829,-0.0064787398321082,0.0,1.0,4829,0.0
300,Mexico,Unknown,2020-11-16,0,0,754200,-750190,0,4010,-0.0053453125208280565,0.0,1.0,4010,0.0
301,Mexico,Unknown,2020-11-17,0,0,757951,-754200,0,3751,-0.004973481835057014,0.0,1.0,3751,0.0
302,Mexico,Unknown,2020-11-18,0,0,762025,-757951,0,4074,-0.005375017646259455,0.0,1.0,4074,0.0
303,Mexico,Unknown,2020-11-19,0,0,766361,-762025,0,4336,-0.005690102030773268,0.0,1.0,4336,0.0
304,Mexico,Unknown,2020-11-20,0,0,770728,-766361,0,4367,-0.005698358867426709,0.0,1.0,4367,0.0
305,Mexico,Unknown,2020-11-21,0,0,770728,-770728,0,0,-0.0,,,0,
306,Mexico,Unknown,2020-11-22,0,0,779104,-770728,0,8376,-0.0108676472114676,0.0,1.0,8376,
307,Mexico,Unknown,2020-11-23,0,0,784693,-779104,0,5589,-0.007173625087279747,0.0,1.0,5589,0.0
308,Mexico,Unknown,2020-11-24,0,0,791516,-784693,0,6823,-0.008695120257221614,0.0,1.0,6823,0.0
309,Mexico,Unknown,2020-11-25,0,0,798037,-791516,0,6521,-0.008238620571157122,0.0,1.0,6521,0.0
310,Mexico,Unknown,2020-11-26,0,0,803581,-798037,0,5544,-0.006947046314895174,0.0,1.0,5544,0.0
311,Mexico,Unknown,2020-11-27,0,0,803581,-803581,0,0,-0.0,,,0,
312,Mexico,Unknown,2020-11-28,0,0,803581,-803581,0,0,-0.0,,,0,
313,Mexico,Unknown,2020-11-29,0,0,818397,-803581,0,14816,-0.01843746927814371,0.0,1.0,14816,
314,Mexico,Unknown,2020-11-30,0,0,823586,-818397,0,5189,-0.0063404435744510304,0.0,1.0,5189,0.0
315,Mexico,Unknown,2020-12-01,0,0,829817,-823586,0,6231,-0.007565694414426666,0.0,1.0,6231,0.0
316,Mexico,Unknown,2020-12-02,0,0,836567,-829817,0,6750,-0.008134323591828078,0.0,1.0,6750,0.0
317,Mexico,Unknown,2020-12-03,0,0,843231,-836567,0,6664,-0.00796588916368922,0.0,1.0,6664,0.0
318,Mexico,Unknown,2020-12-04,0,0,852719,-843231,0,9488,-0.011251958241573186,0.0,1.0,9488,0.0
319,Mexico,Unknown,2020-12-05,0,0,859643,-852719,0,6924,-0.008119908199535838,0.0,1.0,6924,0.0
320,Mexico,Unknown,2020-12-06,0,0,866186,-859643,0,6543,-0.007611299109048756,0.0,1.0,6543,0.0
321,Mexico,Unknown,2020-12-07,0,0,873555,-866186,0,7369,-0.008507410648521218,0.0,1.0,7369,0.0
322,Mexico,Unknown,2020-12-08,0,0,881050,-873555,0,7495,-0.008579883350218361,0.0,1.0,7495,0.0
323,Mexico,Unknown,2020-12-09,0,0,889168,-881050,0,8118,-0.009214006015549628,0.0,1.0,8118,0.0
324,Mexico,Unknown,2020-12-10,0,0,896130,-889168,0,6962,-0.007829791445486118,0.0,1.0,6962,0.0
325,Mexico,Unknown,2020-12-11,0,0,904042,-896130,0,7912,-0.00882907613850669,0.0,1.0,7912,0.0
326,Mexico,Unknown,2020-12-12,0,0,911965,-904042,0,7923,-0.008763973355220223,0.0,1.0,7923,0.0
327,Mexico,Unknown,2020-12-13,0,0,918681,-911965,0,6716,-0.007364317709561222,0.0,1.0,6716,0.0
328,Mexico,Unknown,2020-12-14,0,0,927754,-918681,0,9073,-0.009876115866116747,0.0,1.0,9073,0.0
